########################################
#......................................#
#......................................#
#......................................#
#......................................#
#......................................#
#......................................#
#......................................#
#......................................#
#......................................#
#......................................#
#......................................#
#......................................#
#         ###########                  #
#              #                       #
#              #                       #
#                                      #
#              #                       #
#              #                       #
#         ###########                  #
#......................................#
#......................................#
#......................................#
#......................................#
#......................................#
#......%%%%%%%%%%%%%%..................#
#......%....................x..........#
#......%...............................#
#......................................#
#..............   .....................#
#..............   .....................#
#..............   .....................#
#......................................#
#.%%%%%%...............................#
#.%....%...............................#
#.%.@..%%%.............................#
#.%....%.%.............................#
#.%%%%%%%%.............................#
#......................................#
########################################